111111111
100C000E1
10Q010Q11
1P0010011
111111111