111111111111111111111
1000000000100000000C1
1000101000100001C0011
1P001E100010000000001
111111111111111111111