111011111111111111111
1000000000000000000C1
1000101000100001C0011
1P0011100010000000001
111111111111111111111