NO ./textures/north_brick.xpm
SO ./textures/red_brick.xpm
WE ./textures/red_brick.xpm
EA ./textures/red_brick.xpm

F 85, 107, 47
C 135, 206, 235 

        1111111111111111111111111
        1000000000110000000000001
        1011000001110000000000001
  W      1001000000000000000000001
111111111011000001110000000000001
100000000011000001110111111111111
11100110001111011100000010001
11110111111111011101010010001
11000000110101011100000010001
10000000000000000000000010001
10000000000000011010100100001
110000011101010111110111100011
11110111 1110101 101111010001
11111111 1111111 111111111111