NO ./textures/wall
SO ./textures/wall
WE ./textures/wall
EA ./textures/wall

F 220,100,0
C 225,30,0

111111111111111
100000000000001
100N00000000001
100000000000001
100001111000001
100001001000001
100001001000001
100001111000001
100000000000001
100000000000001
100000000000001
111111111111111