111111111111111111111111111111111111111111
1C0000CCCC000000000C00C0000CCCC000000000C1
1000101000000001C00111000101000000001C0011
1P0010100000000CCCC01100010000000000CCCC01
111111111100000000000000001111111111111111
111100000000000000000000000000000000111111
1C0000CCCC000000000C11C0000CCCC000000000C1
1000111000000001C00111000101000000001C0011
100000000000000CCCC0110001E100000000CCCC01
111111111111111111111111111111111111111111