NO ./textures/moria/wall
SO ./textures/moria/wall
WE ./textures/moria/pillar
EA ./textures/moria/pillar

F 30, 30, 30
C 50, 50, 55

111111111111111111111111111111111111111111111111111111111
10000000000000000000000000S000000000000000000000000000001
100100001000010000100001000010000100001000010000100001001
100000000000000000000000000000000000000000000000000000001
100000000000000000000000000000000000000000000000000000001
100100001000010000100001000010000100001000010000100001001
100000000000000000000000000000000000000000000000000000001
100000000000000000000000000000000000000000000000000000001
100100001000010000100001000010000100001000010000100001001
100000000000000000000000000000000000000000000000000000001
100000000000000000000000000000000000000000000000000000001
100100001000010000100001000010000100001000010000100001001
10000000000000000000000000000000000000000000000000000 001
100000000000000000000000000000000000000000000000000000001
100100001000010000100001000010000100001000010000100001001
100000000000000000000000000000000000000000000000000000001
100000000000000000000000000000000000000000000000000000001
100100001000010000100001000010000100001000010000100001001
100000000000000000000000000000000000000000000000000000001
100000000000000000000000000000000000000000000000000000001
100100001000010000100001000010000100001000010000100001001
100000000000000000000000000000000000000000000000000000001
100000000000000000000000000000000000000000000000000000001
100100001000010000100001000010000100001000010000100001001
100000000000000000000000000000000000000000000000000000001
100000000000000000000000000000000000000000000000000000001
111111111111111111111111111111111111111111111111111111111