111111111111111111111
1C00Q000CC00000Q000C1
10001011000Q0111C0001
1P001E000111000CC0C01
111111111111111111111