111111111111111111111
10Z0000000000000000C1
10P0101000100001C0011
1E0011100010100000001
111111111111111111111