111111111
100C000E1
100010011
1P0010011
111111111