111111111111111111111
1C0000CCCC000000000C1
1000101000000001C0011
100000C00000000000001
100000C00000000000001
100000C00000000000001
100000C00000000000001
100000C00000000000001
100000C00000000000001
100000C00000000000001
100000C00000000000001
100000C00000000000001
1P001E100000000CCCC01
111111111111111111111